################
#   SCS L@  #  #
#    S      #XX#
#      G    #  #
#              #
#       L      #
# V            #
#              #
#             G#
#              #
#              #
#              #
#    S  C      #
#              #
#C            C#
################
