################
#      @    #  #
#           #XX#
#  d        #  #
#              #
#              #
#              #
#              #
#             G#
#              #
#              #
#              #
#  d           #
#              #
#C            C#
################
